WWWWWWWWWWWWWWWWWWWWWWWWWWWWWWWWWWWWWWWWWWWWWWWWWWWWWWWWWWWWWWWWWWWWWWWWWWWWWWWWWWWWWWWWWWWWWWWWWWWWWWWWWWW
W+++++++++++++++++++++++++++++++++++++++++++++++++++++++++++++++++++++++++++++++++++++++++++++++++++++++++W
W+++++++++++++++++++++++++++++++++++++++++++++++++++++++++++++++++++++++++++++++++++++++++++++++++++++++++W
W++WWWWWWWWWWWWWWWWW+++++++++++WWWWWWWWWWWWWWWWW+++++++++++WWWWWWWWWWWWWWWWW+++++++++++WWWWWWWWWWWWWWWWW++W
W++W+++++++++++++++W+++++++++++W+++++++++++++++W+++++++++++W+++++++++++++++W+++++++++++W+++++++++++++++W++W
W++W+++++++++++++++W+++++++++++W+++++++++++++++W+++++++++++W+++++++++++++++W+++++++++++W+++++++++++++++W++W
W++W+++++++++++++++W+++++++++++W+++++++++++++++W+++++++++++W+++++++++++++++W+++++++++++W+++++++++++++++W++W
W++W+++++++++++++++W+++++++++++W+++++++++++++++W+++++++++++W+++++++++++++++W+++++++++++W+++++++++++++++W++W
W++W+++++++++++++++W+++++++++++W+++++++++++++++W+++++++++++W+++++++++++++++W+++++++++++W+++++++++++++++W++W
W++W+++++++++++++++W+++++++++++W+++++++++++++++W+++++++++++W+++++++++++++++W+++++++++++W+++++++++++++++W++W
W++W+++++++++++++++W+++++++++++W+++++++++++++++W+++++++++++W+++++++++++++++W+++++++++++W+++++++++++++++W++W
W++W+++++++++++++++W+++++++++++W+++++++++++++++W+++++++++++W+++++++++++++++W+++++++++++W+++++++++++++++W++W
W++W+++++++++++++++W+++++++++++W+++++++++++++++W+++++++++++W+++++++++++++++W+++++++++++W+++++++++++++++W++W
W++W+++++++++++++++W+++++++++++W+++++++++++++++W+++++++++++W+++++++++++++++W+++++++++++W+++++++++++++++W++W
W++W+++++++++++++++W+++++++++++W+++++++++++++++W+++++++++++W+++++++++++++++W+++++++++++W+++++++++++++++W++W
W++W+++++++++++++++W+++++++++++W+++++++++++++++W+++++++++++W+++++++++++++++W+++++++++++W+++++++++++++++W++W
W++W+++++++++++++++W+++++++++++W+++++++++++++++W+++++++++++W+++++++++++++++W+++++++++++W+++++++++++++++W++W
W++W+++++++++++++++W+++++++++++W+++++++++++++++W+++++++++++W+++++++++++++++W+++++++++++W+++++++++++++++W++W
W++W+++++++++++++++W+++++++++++W+++++++++++++++W+++++++++++W+++++++++++++++W+++++++++++W+++++++++++++++W++W
W++W+++++++++++++++W+++++++++++W+++++++++++++++W+++++++++++W+++++++++++++++W+++++++++++W+++++++++++++++W++W
W++W+++++++++++++++W+++++++++++W+++++++++++++++W+++++++++++W+++++++++++++++W+++++++++++W+++++++++++++++W++W
W++W+++++++++++++++W+++++++++++W+++++++++++++++W+++++++++++W+++++++++++++++W+++++++++++W+++++++++++++++W++W
W++W+++++++++++++++W+++++++++++W+++++++++++++++W+++++++++++W+++++++++++++++W+++++++++++W+++++++++++++++W++W
W++W+++++++++++++++W+++++++++++W+++++++++++++++W+++++++++++W+++++++++++++++W+++++++++++W+++++++++++++++W++W
W++W+++++++++++++++W+++++++++++W+++++++++++++++W+++++++++++W+++++++++++++++W+++++++++++W+++++++++++++++W++W
W++W+++++++++++++++W+++++++++++W+++++++++++++++W+++++++++++W+++++++++++++++W+++++++++++W+++++++++++++++W++W
W++W+++++++++++++++W+++++++++++W+++++++++++++++W+++++++++++W+++++++++++++++W+++++++++++W+++++++++++++++W++W
W++W+++++++++++++++W+++++++++++W+++++++++++++++W+++++++++++W+++++++++++++++W+++++++++++W+++++++++++++++W++W
W++W+++++++++++++++W+++++++++++W+++++++++++++++W+++++++++++W+++++++++++++++W+++++++++++W+++++++++++++++W++W
W++W+++++++++++++++W+++++++++++W+++++++++++++++W+++++++++++W+++++++++++++++W+++++++++++W+++++++++++++++W++W
W++W+++++++++++++++W+++++++++++W+++++++++++++++W+++++++++++W+++++++++++++++W+++++++++++W+++++++++++++++W++W
W++W+++++++++++++++W+++++++++++W+++++++++++++++W+++++++++++W+++++++++++++++W+++++++++++W+++++++++++++++W++W
W++W+++++++++++++++W+++++++++++W+++++++++++++++W+++++++++++W+++++++++++++++W+++++++++++W+++++++++++++++W++W
W++W+++++++++++++++W+++++++++++W+++++++++++++++W+++++++++++W+++++++++++++++W+++++++++++W+++++++++++++++W++W
W++W+++++++++++++++W+++++++++++W+++++++++++++++W+++++++++++W+++++++++++++++W+++++++++++W+++++++++++++++W++W
W++W+++++++++++++++W+++++++++++W+++++++++++++++W+++++++++++W+++++++++++++++WWWWWWWWWWWWW+++++++++++++++W++W
W++W+++++++++++++++W+++++++++++W+++++++++++++++W+++++++++++W+++++++++++++++++++++++++++++++++++++++++++W++W
W++W+++++++++++++++W+++++++++++W+++++++++++++++W+++++++++++W+++++++++++++++++++++++++++++++++++++++++++W++W
W++W+++++++++++++++W+++++++++++W+++++++++++++++W+++++++++++W+++++++++++++++++++++++++++++++++++++++++++W++W
W++W+++++++++++++++W+++++++++++W+++++++++++++++W+++++++++++W+++++++++++++++++++++++++++++++++++++++++++W++W
W++W+++++++++++++++W+++++++++++W+++++++++++++++W+++++++++++W+++++++++++++++++++++++++++++++++++++++++++W++W
W++W+++++++++++++++W+++++++++++W+++++++++++++++W+++++++++++W+++++++++++++++WWWWWWWWWWWWW+++++++++++++++W++W
W++W+++++++++++++++WWWWWWWWWWWWW+++++++++++++++WWWWWWWWWWWWW++++++++++WWWWWW+++++++++++WWWWWWWWWWWWWWW+W++W
W++W++++++++++++++++++++++++++++++++++++++++++++++++++++++++++++++++++W+++++++++++++++++++++++++++++++++++W
W++W++++++++++++++++++++++++++++++++++++++++++++++++++++++++++++++++++W+++++++++++++++++++++++++++++++++++W
W++W++++++++++++++++++++++++++++++++++++++++++++++++++++++++++++++++++W+++++++++++++++++++++++++++++++++++W
W++W++++++++++++++++++++++++++++++++++++++++++++++++++++++++++++++++++W+++++++++++++++++++++++++++++++++++W
W++WWWWWW++++++++++WWWWWWWWWWWWW++++++++++++++++++++++++++++++++++++++W+++++++++++++++++++++++++++++++++++W
W+++++++W++++++++++W+++++++++++W++++++++++++++++++++++++++++++++++++++W+++++++++++++++++++++++++++++++++++W
W+++++++W++++++++++W+++++++++++W++++++++++++++++++++++++++++++++++++++W+++++++++++++++++++++++++++++++++++W
W+++++++W++++++++++W+++++++++++W++++++++++++++++++++++++++++++++++++++W+++++++++++++++++++++++++++++++++++W
W+++++WWW++++++++++W+++++++++++W++++++++++++++++++++++++++++++++++++++W+++++++++++++++++++++++++++++++++++W
W+++++W++++++++++++W+++++++++++W++++++++++++++++++++++++++++++++++++++W+++++++++++++++++++++++++++++++++++W
W+++++W++++++++++++W+++++++++++W++++++++++++++++++++++++++++++++++++++W+++++++++++++++++++++++++++++++++++W
W+++++W++++++++++++W+++++++++++W++++++++++++++++++++++++++++++++++++++W+++++++++++++++++++++++++++++++++++W
W+++++WWW++++++++++W+++++++++++W++++++++++++++++++++++++++++++++++++++W+++++++++++++++++++++++++++++++++++W
W+++++++W++++++++++W+++++++++++W++++++++++++++++++++++++++++++++++++++W+++++++++++++++++++++++++++++++++++W
W+++++++W++++++++++W+++++++++++W++++++++++++++++++++++++++++++++++++++W+++++++++++++++++++++++++++++++++++W
W+++++++W++++++++++W+++++++++++W++++++++++++++++++++++++++++++++++++++W+++++++++++++++++++++++++++++++++++W
W+++++++W++++++++++W+++++++++++W++++++++++++++++++++++++++++++++++++++W+++++++++++++++++++++++++++++++++++W
W+++++++W++++++++++W+++++++++++W++++++++++++++++++++++++++++++++++++++W+++++++++++++++++++++++++++++++++++W
W+++++++W++++++++++W+++++++++++W++++++++++++++++++++++++++++++++++++++W+++++++++++++++++++++++++++++++++++W
W+++++++W++++++++++WWWWWWWWWWWWW++++++++++++++++++++++++++++++++++++++WWWWWW++++++++++++++++++++++++++++++W
W+++++++W++++++++++++++++++++++++++++++++++++++++++++++++++++++++++++++++++W++++++++++++++++++++++++++++++W
W++WWWWWW++++++++++++++++++++++++++++++++++++++++++++++++++++++++++++++++++W++++++++++++++++++++++++++++++W
W++W+++++++++++++++++++++++++++++++++++++++++++++++++++++++++++++++++++++++W++++++++++++++++++++++++++++++W
W++W+++++++++++++++++++++++++++++++++++++++++++++++++++++++++++++++++++++++W++++++++++++++++++++++++++++++W
W++W+++++++++++++++++++++++++++++++++++++++++++++++++++++++++++++++++++++++W++++++++++++++++++++++++++++++W
W++W+++++++++++++++++++++++++++++++++++++++++++++++++++++++++++++++++++++++W++++++++++++++++++++++++++++++W
W++W+++++++++++++++++++++++++++++++++++++++++++++++++++++++++++++++++++++++W++++++++++++++++++++++++++++++W
W++W+++++++++++++++++++++++++++++++++++++++++++++++++++++++++++++++++++++++W++++++++++++++++++++++++++++++W
W++W+++++++++++++++++++++++++++++++++++WWWWWWWWWWWWWWWWW+++++++++++++++++++WWW++++++++++++++++++++++++++++W
W++W+++++++++++++++++++++++++++++++++++W+++++++++++++++W+++++++++++++++++++++W++++++++++++++++++++++++++++W
W++W+++++++++++++++++++++++++++++++++++W+++++++++++++++W+++++++++++++++++++++W++++++++++++++++++++++++++++W
W++WWWWWWWWWW+++WWW+++WWW+++WWWWWWWWWWWW+++++++++++++++W+++++++++++++++++++++W++++++++++++++++++++++++++++W
W+++++++++++W+++W+W+++W+W+++W++++++++++++++++++++++++++W+++++++++++++++++++++W++++++++++++++++++++++++++++W
W++++++++++++++++++++++++++++++++++++++++++++++++++++++W+++++++++++++++++++++W++++++++++++++++++++++++++++W
W++++++++++++++++++++++++++++++++++++++++++++++++++++++W+++++++++++++++++++++W++++++++++++++++++++++++++++W
W++++++++++++++++++++++++++++++++++++++++++++++++++++++W+++++++++++++++++++++W++++++++++++++++++++++++++++W
W++++++++++++++++++++++++++++++++++++++++++++++++++++++W+++++++++++++++++++++W++++++++++++++++++++++++++++W
W++++++++++++++++++++++++++++++++++++++++++++++++++++++W+++++++++++++++++++++W++++++++++++++++++++++++++++W
W++++++++++++++++++++++++++++++++++++++++++++++++++++++W+++++++++++++++++++++W++++++++++++++++++++++++++++W
W++++++++++++++++++++++++++++++++++++++++++++++++++++++W+++++++++++++++++++++W++++++++++++++++++++++++++++W
W+++++++++++++++++++P++++++++++++++++++++++++++++++++++W+++++++++++++++++++++W++++++++++++++++++++++++++++W
W++++++++++++++++++++++++++++++++++++++++++++++++++++++W+++++++++++++++++++++W++++++++++++++++++++++++++++W
W++++++++++++++++++++++++++++++++++++++++++++++++++++++W+++++++++++++++++++++W++++++++++++++++++++++++++++W
W++++++++++++++++++++++++++++++++++++++++++++++++++++++W+++++++++++++++++++++W++++++++++++++++++++++++++++W
W++++++++++++++++++++++++++++++++++++++++++++++++++++++W+++++++++++++++++++++W++++++++++++++++++++++++++++W
W++++++++++++++++++++++++++++++++++++++++++++++++++++++W+++++++++++++++++++++W++++++++++++++++++++++++++++W
W++++++++++++++++++++++++++++++++++++++++++++++++++++++W+++++++++++++++++++++W++++++++++++++++++++++++++++W
W++++++++++++++++++++++++++++++++++++++++++++++++++++++W+++++++++++++++++++++W++++++++++++++++++++++++++++W
W++++++++++++++++++++++++++++++++++++++++++++++++++++++W+++++++++++++++++++++W++++++++++++++++++++++++++++W
W++++++++++++++++++++++++++++++++++++++++++++++++++++++W+++++++++++++++++++++W++++++++++++++++++++++++++++W
W++++++++++++++++++++++++++++++++++++++++++++++++++++++W+++++++++++++++++++++W++++++++++++++++++++++++++++W
W++++++++++++++++++++++++++++++++++++++++++++++++++++++W+++++++++++++++++++++W++++++++++++++++++++++++++++W
W++++++++++++++++++++++++++++++++++++++++++++++++++++++W+++++++++++++++++++++W++++++++++++++++++++++++++++W
W++++++++++++++++++++++++++++++++++++++++++++++++++++++W+++++++++++++++++++++W++++++++++++++++++++++++++++W
W++++++++++++++++++++++++++++++++++++++++++++++++++++++W+++++++++++++++++++++W++++++++++++++++++++++++++++W
W++++++++++++++++++++++++++++++++++++++++++++++++++++++W+++++++++++++++++++++W++++++++++++++++++++++++++++W
W++++++++++++++++++++++++++++++++++++++++++++++++++++++W+++++++++++++++++++++W++++++++++++++++++++++++++++W
W++++++++++++++++++++++++++++++++++++++++++++++++++++++W+++++++++++++++++++++W++++++++++++++++++++++++++++W
W++++++++++++++++++++++++++++++++++++++++++++++++++++++WWWWWWWWWWWWWWWWWWWWWWW++++++++++++++++++++++++++++W
W+++++++++++++++++++++++++++++++++++++++++++++++++++++++++++++++++++++++++++++++++++++++++++++++++++++++++W
W+++++++++++++++++++++++++++++++++++++++++++++++++++++++++++++++++++++++++++++++++++++++++++++++++++++++++W
WWWWWWWWWWWWWWWWWWWWWWWWWWWWWWWWWWWWWWWWWWWWWWWWWWWWWWWWWWWWWWWWWWWWWWWWWWWWWWWWWWWWWWWWWWWWWWWWWWWWWWWWWWW
