WWWWWWWWWWWWWWWWWWWWWWWWWWWWWWWWWWWWWWWWWWWWWWWWWWWWWWWWWWWWWWWWWWWWWWWWWWWWWWWWWWWWWWWWWWWWWWWWWWWWWWWWWWW
W+++++++++++++++++++++++++++++++++++++++++++++++++++++++++++++++++++++++++++++++++++++++++++++++++++++++++W
W+++++++++++++++++++++++++++++++++++++++++++++++++++++++++++++++++++++++++++++++++++++++++++++++++++++++++W
W++WWWWWWWWWWWWWWWWW+++++++++++WWWWWWWWWWWWWWWWW+++++++++++WWWWWWWWWWWWWWWWW+++++++++++WWWWWWWWWWWWWWWWW++W
W++WGGGGGGGGGGGGGGGW+++++++++++WGGGGGGGGGGGGGGGW+++++++++++WGGGGGGGGGGGGGGGW+++++++++++WGGGGGGGGGGGGGGGW++W
W++WGGGGGGGGGGGGGGGW+++++++++++WGGGGGGGGGGGGGGGW+++++++++++WGGGGGGGGGGGGGGGW+++++++++++WGGGGGGGGGGGGGGGW++W
W++WGGGGGGGGGGGGGGGW+++++++++++WGGGGGGGGGGGGGGGW+++++++++++WGGGGGGGGGGGGGGGW+++++++++++WGGGGGGGGGGGGGGGW++W
W++WGGGGGGGGGGGGGGGW+++++++++++WGGGGGGGGGGGGGGGW+++++++++++WGGGGGGGGGGGGGGGW+++++++++++WGGGGGGGGGGGGGGGW++W
W++WGGGGGGGGGGGGGGGW+++++++++++WGGGGGGGGGGGGGGGW+++++++++++WGGGGGGGGGGGGGGGW+++++++++++WGGGGGGGGGGGGGGGW++W
W++WGGGGGGGGGGGGGGGW+++++++++++WGGGGGGGGGGGGGGGW+++++++++++WGGGGGGGGGGGGGGGW+++++++++++WGGGGGGGGGGGGGGGW++W
W++WGGGGGGGGGGGGGGGW+++++++++++WGGGGGGGGGGGGGGGW+++++++++++WGGGGGGGGGGGGGGGW+++++++++++WGGGGGGGGGGGGGGGW++W
W++WGGGGGGGGGGGGGGGW+++++++++++WGGGGGGGGGGGGGGGW+++++++++++WGGGGGGGGGGGGGGGW+++++++++++WGGGGGGGGGGGGGGGW++W
W++WGGGGGGGGGGGGGGGW+++++++++++WGGGGGGGGGGGGGGGW+++++++++++WGGGGGGGGGGGGGGGW+++++++++++WGGGGGGGGGGGGGGGW++W
W++WGGGGGGGGGGGGGGGW+++++++++++WGGGGGGGGGGGGGGGW+++++++++++WGGGGGGGGGGGGGGGW+++++++++++WGGGGGGGGGGGGGGGW++W
W++WGGGGGGGGGGGGGGGW+++++++++++WGGGGGGGGGGGGGGGW+++++++++++WGGGGGGGGGGGGGGGW+++++++++++WGGGGGGGGGGGGGGGW++W
W++WGGGGGGGGGGGGGGGW+++++++++++WGGGGGGGGGGGGGGGW+++++++++++WGGGGGGGGGGGGGGGW+++++++++++WGGGGGGGGGGGGGGGW++W
W++WGGGGGGGGGGGGGGGW+++++++++++WGGGGGGGGGGGGGGGW+++++++++++WGGGGGGGGGGGGGGGW+++++++++++WGGGGGGGGGGGGGGGW++W
W++WGGGGGGGGGGGGGGGW+++++++++++WGGGGGGGGGGGGGGGW+++++++++++WGGGGGGGGGGGGGGGW+++++++++++WGGGGGGGGGGGGGGGW++W
W++WGGGGGGGGGGGGGGGW+++++++++++WGGGGGGGGGGGGGGGW+++++++++++WGGGGGGGGGGGGGGGW+++++++++++WGGGGGGGGGGGGGGGW++W
W++WGGGGGGGGGGGGGGGW+++++++++++WGGGGGGGGGGGGGGGW+++++++++++WGGGGGGGGGGGGGGGW+++++++++++WGGGGGGGGGGGGGGGW++W
W++WGGGGGGGGGGGGGGGW+++++++++++WGGGGGGGGGGGGGGGW+++++++++++WGGGGGGGGGGGGGGGW+++++++++++WGGGGGGGGGGGGGGGW++W
W++WGGGGGGGGGGGGGGGW+++++++++++WGGGGGGGGGGGGGGGW+++++++++++WGGGGGGGGGGGGGGGW+++++++++++WGGGGGGGGGGGGGGGW++W
W++WGGGGGGGGGGGGGGGW+++++++++++WGGGGGGGGGGGGGGGW+++++++++++WGGGGGGGGGGGGGGGW+++++++++++WGGGGGGGGGGGGGGGW++W
W++WGGGGGGGGGGGGGGGW+++++++++++WGGGGGGGGGGGGGGGW+++++++++++WGGGGGGGGGGGGGGGW+++++++++++WGGGGGGGGGGGGGGGW++W
W++WGGGGGGGGGGGGGGGW+++++++++++WGGGGGGGGGGGGGGGW+++++++++++WGGGGGGGGGGGGGGGW+++++++++++WGGGGGGGGGGGGGGGW++W
W++WGGGGGGGGGGGGGGGW+++++++++++WGGGGGGGGGGGGGGGW+++++++++++WGGGGGGGGGGGGGGGW+++++++++++WGGGGGGGGGGGGGGGW++W
W++WGGGGGGGGGGGGGGGW+++++++++++WGGGGGGGGGGGGGGGW+++++++++++WGGGGGGGGGGGGGGGW+++++++++++WGGGGGGGGGGGGGGGW++W
W++WGGGGGGGGGGGGGGGW+++++++++++WGGGGGGGGGGGGGGGW+++++++++++WGGGGGGGGGGGGGGGW+++++++++++WGGGGGGGGGGGGGGGW++W
W++WGGGGGGGGGGGGGGGW+++++++++++WGGGGGGGGGGGGGGGW+++++++++++WGGGGGGGGGGGGGGGW+++++++++++WGGGGGGGGGGGGGGGW++W
W++WGGGGGGGGGGGGGGGW+++++++++++WGGGGGGGGGGGGGGGW+++++++++++WGGGGGGGGGGGGGGGW+++++++++++WGGGGGGGGGGGGGGGW++W
W++WGGGGGGGGGGGGGGGW+++++++++++WGGGGGGGGGGGGGGGW+++++++++++WGGGGGGGGGGGGGGGW+++++++++++WGGGGGGGGGGGGGGGW++W
W++WGGGGGGGGGGGGGGGW+++++++++++WGGGGGGGGGGGGGGGW+++++++++++WGGGGGGGGGGGGGGGW+++++++++++WGGGGGGGGGGGGGGGW++W
W++WGGGGGGGGGGGGGGGW+++++++++++WGGGGGGGGGGGGGGGW+++++++++++WGGGGGGGGGGGGGGGW+++++++++++WGGGGGGGGGGGGGGGW++W
W++WGGGGGGGGGGGGGGGW+++++++++++WGGGGGGGGGGGGGGGW+++++++++++WGGGGGGGGGGGGGGGW+++++++++++WGGGGGGGGGGGGGGGW++W
W++WGGGGGGGGGGGGGGGW+++++++++++WGGGGGGGGGGGGGGGW+++++++++++WGGGGGGGGGGGGGGGW+++++++++++WGGGGGGGGGGGGGGGW++W
W++WGGGGGGGGGGGGGGGW+++++++++++WGGGGGGGGGGGGGGGW+++++++++++WGGGGGGGGGGGGGGGW+++++++++++WGGGGGGGGGGGGGGGW++W
W++WGGGGGGGGGGGGGGGW+++++++++++WGGGGGGGGGGGGGGGW+++++++++++WGGGGGGGGGGGGGGGW+++++++++++WGGGGGGGGGGGGGGGW++W
W++WGGGGGGGGGGGGGGGW+++++++++++WGGGGGGGGGGGGGGGW+++++++++++WGGGGGGGGGGGGGGGW+++++++++++WGGGGGGGGGGGGGGGW++W
W++WGGGGGGGGGGGGGGGW+++++++++++WGGGGGGGGGGGGGGGW+++++++++++WGGGGGGGGGGGGGGGW+++++++++++WGGGGGGGGGGGGGGGW++W
W++WGGGGGGGGGGGGGGGW+++++++++++WGGGGGGGGGGGGGGGW+++++++++++WGGGGGGGGGGGGGGGWWWWWWWWWWWWWGGGGGGGGGGGGGGGW++W
W++WGGGGGGGGGGGGGGGW+++++++++++WGGGGGGGGGGGGGGGW+++++++++++WGGGGGGGGGGGGGGGGGGGGGGGGGGGGGGGGGGGGGGGGGGGW++W
W++WGGGGGGGGGGGGGGGW+++++++++++WGGGGGGGGGGGGGGGW+++++++++++WGGGGGGGGGGGGGGGGGGGGGGGGGGGGGGGGGGGGGGGGGGGW++W
W++WGGGGGGGGGGGGGGGW+++++++++++WGGGGGGGGGGGGGGGW+++++++++++WGGGGGGGGGGGGGGGGGGGGGGGGGGGGGGGGGGGGGGGGGGGW++W
W++WGGGGGGGGGGGGGGGW+++++++++++WGGGGGGGGGGGGGGGW+++++++++++WGGGGGGGGGGGGGGGGGGGGGGGGGGGGGGGGGGGGGGGGGGGW++W
W++WGGGGGGGGGGGGGGGW+++++++++++WGGGGGGGGGGGGGGGW+++++++++++WGGGGGGGGGGGGGGGGGGGGGGGGGGGGGGGGGGGGGGGGGGGW++W
W++WGGGGGGGGGGGGGGGW+++++++++++WGGGGGGGGGGGGGGGW+++++++++++WGGGGGGGGGGGGGGGWWWWWWWWWWWWWGGGGGGGGGGGGGGGW++W
W++WGGGGGGGGGGGGGGGWWWWWWWWWWWWWGGGGGGGGGGGGGGGWWWWWWWWWWWWWGGGGGGGGGGWWWWWW+++++++++++WWWWWWWWWWWWWWWWW++W
W++WGGGGGGGGGGGGGGGGGGGGGGGGGGGGGGGGGGGGGGGGGGGGGGGGGGGGGGGGGGGGGGGGGGW+++++++++++++++++++++++++++++++++++W
W++WGGGGGGGGGGGGGGGGGGGGGGGGGGGGGGGGGGGGGGGGGGGGGGGGGGGGGGGGGGGGGGGGGGW+++++++++++++++++++++++++++++++++++W
W++WGGGGGGGGGGGGGGGGGGGGGGGGGGGGGGGGGGGGGGGGGGGGGGGGGGGGGGGGGGGGGGGGGGW+++++++++++++++++++++++++++++++++++W
W++WGGGGGGGGGGGGGGGGGGGGGGGGGGGGGGGGGGGGGGGGGGGGGGGGGGGGGGGGGGGGGGGGGGW+++++++++++++++++++++++++++++++++++W
W++WWWWWWGGGGGGGGGGWWWWWWWWWWWWWGGGGGGGGGGGGGGGGGGGGGGGGGGGGGGGGGGGGGGW+++++++++++++++++++++++++++++++++++W
W+++++++WGGGGGGGGGGW+++++++++++WGGGGGGGGGGGGGGGGGGGGGGGGGGGGGGGGGGGGGGW+++++++++++++++++++++++++++++++++++W
W+++++++WGGGGGGGGGGW+++++++++++WGGGGGGGGGGGGGGGGGGGGGGGGGGGGGGGGGGGGGGW+++++++++++++++++++++++++++++++++++W
W+++++++WGGGGGGGGGGW+++++++++++WGGGGGGGGGGGGGGGGGGGGGGGGGGGGGGGGGGGGGGW+++++++++++++++++++++++++++++++++++W
W+++++WWWGGGGGGGGGGW+++++++++++WGGGGGGGGGGGGGGGGGGGGGGGGGGGGGGGGGGGGGGW+++++++++++++++++++++++++++++++++++W
W+++++WGGGGGGGGGGGGW+++++++++++WGGGGGGGGGGGGGGGGGGGGGGGGGGGGGGGGGGGGGGW+++++++++++++++++++++++++++++++++++W
W+++++WGGGGGGGGGGGGW+++++++++++WGGGGGGGGGGGGGGGGGGGGGGGGGGGGGGGGGGGGGGW+++++++++++++++++++++++++++++++++++W
W+++++WGGGGGGGGGGGGW+++++++++++WGGGGGGGGGGGGGGGGGGGGGGGGGGGGGGGGGGGGGGW+++++++++++++++++++++++++++++++++++W
W+++++WWWGGGGGGGGGGW+++++++++++WGGGGGGGGGGGGGGGGGGGGGGGGGGGGGGGGGGGGGGW+++++++++++++++++++++++++++++++++++W
W+++++++WGGGGGGGGGGW+++++++++++WGGGGGGGGGGGGGGGGGGGGGGGGGGGGGGGGGGGGGGW+++++++++++++++++++++++++++++++++++W
W+++++++WGGGGGGGGGGW+++++++++++WGGGGGGGGGGGGGGGGGGGGGGGGGGGGGGGGGGGGGGW+++++++++++++++++++++++++++++++++++W
W+++++++WGGGGGGGGGGW+++++++++++WGGGGGGGGGGGGGGGGGGGGGGGGGGGGGGGGGGGGGGW+++++++++++++++++++++++++++++++++++W
W+++++++WGGGGGGGGGGW+++++++++++WGGGGGGGGGGGGGGGGGGGGGGGGGGGGGGGGGGGGGGW+++++++++++++++++++++++++++++++++++W
W+++++++WGGGGGGGGGGW+++++++++++WGGGGGGGGGGGGGGGGGGGGGGGGGGGGGGGGGGGGGGW+++++++++++++++++++++++++++++++++++W
W+++++++WGGGGGGGGGGW+++++++++++WGGGGGGGGGGGGGGGGGGGGGGGGGGGGGGGGGGGGGGW+++++++++++++++++++++++++++++++++++W
W+++++++WGGGGGGGGGGWWWWWWWWWWWWWGGGGGGGGGGGGGGGGGGGGGGGGGGGGGGGGGGGGGGWWWWWW++++++++++++++++++++++++++++++W
W+++++++WGGGGGGGGGGGGGGGGGGGGGGGGGGGGGGGGGGGGGGGGGGGGGGGGGGGGGGGGGGGGGGGGGGW++++++++++++++++++++++++++++++W
W++WWWWWWGGGGGGGGGGGGGGGGGGGGGGGGGGGGGGGGGGGGGGGGGGGGGGGGGGGGGGGGGGGGGGGGGGW++++++++++++++++++++++++++++++W
W++WGGGGGGGGGGGGGGGGGGGGGGGGGGGGGGGGGGGGGGGGGGGGGGGGGGGGGGGGGGGGGGGGGGGGGGGW++++++++++++++++++++++++++++++W
W++WGGGGGGGGGGGGGGGGGGGGGGGGGGGGGGGGGGGGGGGGGGGGGGGGGGGGGGGGGGGGGGGGGGGGGGGW++++++++++++++++++++++++++++++W
W++WGGGGGGGGGGGGGGGGGGGGGGGGGGGGGGGGGGGGGGGGGGGGGGGGGGGGGGGGGGGGGGGGGGGGGGGW++++++++++++++++++++++++++++++W
W++WGGGGGGGGGGGGGGGGGGGGGGGGGGGGGGGGGGGGGGGGGGGGGGGGGGGGGGGGGGGGGGGGGGGGGGGW++++++++++++++++++++++++++++++W
W++WGGGGGGGGGGGGGGGGGGGGGGGGGGGGGGGGGGGGGGGGGGGGGGGGGGGGGGGGGGGGGGGGGGGGGGGW++++++++++++++++++++++++++++++W
W++WGGGGGGGGGGGGGGGGGGGGGGGGGGGGGGGGGGGGGGGGGGGGGGGGGGGGGGGGGGGGGGGGGGGGGGGW++++++++++++++++++++++++++++++W
W++WGGGGGGGGGGGGGGGGGGGGGGGGGGGGGGGGGGGWWWWWWWWWWWWWWWWWGGGGGGGGGGGGGGGGGGGWWW++++++++++++++++++++++++++++W
W++WGGGGGGGGGGGGGGGGGGGGGGGGGGGGGGGGGGGW+++++++++++++++WGGGGGGGGGGGGGGGGGGGGGW++++++++++++++++++++++++++++W
W++WGGGGGGGGGGGGGGGGGGGGGGGGGGGGGGGGGGGW+++++++++++++++WGGGGGGGGGGGGGGGGGGGGGW++++++++++++++++++++++++++++W
W++WWWWWWWWWWGGGWWWGGGWWWGGGWWWWWWWWWWWW+++++++++++++++WGGGGGGGGGGGGGGGGGGGGGW++++++++++++++++++++++++++++W
W+++++++++++W+++W+W+++W+W+++W++++++++++++++++++++++++++WGGGGGGGGGGGGGGGGGGGGGW++++++++++++++++++++++++++++W
W++++++++++++++++++++++++++++++++++++++++++++++++++++++WGGGGGGGGGGGGGGGGGGGGGW++++++++++++++++++++++++++++W
W++++++++++++++++++++++++++++++++++++++++++++++++++++++WGGGGGGGGGGGGGGGGGGGGGW++++++++++++++++++++++++++++W
W++++++++++++++++++++++++++++++++++++++++++++++++++++++WGGGGGGGGGGGGGGGGGGGGGW++++++++++++++++++++++++++++W
W++++++++++++++++++++++++++++++++++++++++++++++++++++++WGGGGGGGGGGGGGGGGGGGGGW++++++++++++++++++++++++++++W
W++++++++++++++++++++++++++++++++++++++++++++++++++++++WGGGGGGGGGGGGGGGGGGGGGW++++++++++++++++++++++++++++W
W++++++++++++++++++++++++++++++++++++++++++++++++++++++WGGGGGGGGGGGGGGGGGGGGGW++++++++++++++++++++++++++++W
W++++++++++++++++++++++++++++++P+++++++++++++++++++++++WGGGGGGGGGGGGGGGGGGGGGW++++++++++++++++++++++++++++W
W++++++++++++++++++++++++++++++++++++++++++++++++++++++WGGGGGGGGGGGGGGGGGGGGGW++++++++++++++++++++++++++++W
W++++++++++++++++++++++++++++++++++++++++++++++++++++++WGGGGGGGGGGGGGGGGGGGGGW++++++++++++++++++++++++++++W
W++++++++++++++++++++++++++++++++++++++++++++++++++++++WGGGGGGGGGGGGGGGGGGGGGW++++++++++++++++++++++++++++W
W++++++++++++++++++++++++++++++++++++++++++++++++++++++WGGGGGGGGGGGGGGGGGGGGGW++++++++++++++++++++++++++++W
W++++++++++++++++++++++++++++++++++++++++++++++++++++++WGGGGGGGGGGGGGGGGGGGGGW++++++++++++++++++++++++++++W
W++++++++++++++++++++++++++++++++++++++++++++++++++++++WGGGGGGGGGGGGGGGGGGGGGW++++++++++++++++++++++++++++W
W++++++++++++++++++++++++++++++++++++++++++++++++++++++WGGGGGGGGGGGGGGGGGGGGGW++++++++++++++++++++++++++++W
W++++++++++++++++++++++++++++++++++++++++++++++++++++++WGGGGGGGGGGGGGGGGGGGGGW++++++++++++++++++++++++++++W
W++++++++++++++++++++++++++++++++++++++++++++++++++++++WGGGGGGGGGGGGGGGGGGGGGW++++++++++++++++++++++++++++W
W++++++++++++++++++++++++++++++++++++++++++++++++++++++WGGGGGGGGGGGGGGGGGGGGGW++++++++++++++++++++++++++++W
W++++++++++++++++++++++++++++++++++++++++++++++++++++++WGGGGGGGGGGGGGGGGGGGGGW++++++++++++++++++++++++++++W
W++++++++++++++++++++++++++++++++++++++++++++++++++++++WGGGGGGGGGGGGGGGGGGGGGW++++++++++++++++++++++++++++W
W++++++++++++++++++++++++++++++++++++++++++++++++++++++WGGGGGGGGGGGGGGGGGGGGGW++++++++++++++++++++++++++++W
W++++++++++++++++++++++++++++++++++++++++++++++++++++++WGGGGGGGGGGGGGGGGGGGGGW++++++++++++++++++++++++++++W
W++++++++++++++++++++++++++++++++++++++++++++++++++++++WGGGGGGGGGGGGGGGGGGGGGW++++++++++++++++++++++++++++W
W++++++++++++++++++++++++++++++++++++++++++++++++++++++WGGGGGGGGGGGGGGGGGGGGGW++++++++++++++++++++++++++++W
W++++++++++++++++++++++++++++++++++++++++++++++++++++++WGGGGGGGGGGGGGGGGGGGGGW++++++++++++++++++++++++++++W
W++++++++++++++++++++++++++++++++++++++++++++++++++++++WGGGGGGGGGGGGGGGGGGGGGW++++++++++++++++++++++++++++W
W++++++++++++++++++++++++++++++++++++++++++++++++++++++WWWWWWWWWWWWWWWWWWWWWWW++++++++++++++++++++++++++++W
W+++++++++++++++++++++++++++++++++++++++++++++++++++++++++++++++++++++++++++++++++++++++++++++++++++++++++W
W+++++++++++++++++++++++++++++++++++++++++++++++++++++++++++++++++++++++++++++++++++++++++++++++++++++++++W
WWWWWWWWWWWWWWWWWWWWWWWWWWWWWWWWWWWWWWWWWWWWWWWWWWWWWWWWWWWWWWWWWWWWWWWWWWWWWWWWWWWWWWWWWWWWWWWWWWWWWWWWWWW
